
NO bbb.xpm
SO hhh.xpm
EA a.xpm
WE b.xpm

F 105,105,105
C 188,200,198

11111111111111111
11111000000000001
10100000100000101
11100000000000001
11111000100010001
10000000000000001
10101010001010101
10000000000000001
11110111111111111
10000000100100001
100E0001000000001 
10100010100001001
11000001000000001
11111111111111111
