
NO bbb.xpm
SO hhh.xpm
EA a.xpm
WE b.xpm

C 188,200,198
F 105,105,105

11111111111111111
1100W000000000001
10100000100000101
10000000000000001
11111000100010001
10000000000000001
10101010001010101
10000000000000001
11110111111111111
10000000100100001
10000000000000001
10100000100001001
11000000000000001
11111111111111111