NO eagle.xpm
SO AnyConv.com__pixil-frame-0.xpm
EA a.xpm
WE b.xpm

F 105,105,105
C 188,200,198

111111111111111
100000100000001
100001011111111
100000110100001
100000111100001
10001N110100001
111111111111111